AAS = "countries/Ahrar_al-Sham.txt"
ALN = "countries/Al-Nusra.txt"
ANS = "countries/Ansar_al-Sham.txt"
ARA = "countries/Saudi Arabia.txt"
BAI = "countries/Baathist_Iraq.txt"
BRI = "countries/Britain.txt"
CYP = "countries/Cyprus.txt"
DFB = "countries/Dawn of Freedom Brigades.txt"
EGT = "countries/Egypt.txt"
EUP = "countries/Euphrates Shield.txt"
FLS = "countries/Faylaq al-Sham.txt"
FSA = "countries/Free Syrian Army.txt"
GIF = "countries/GIF.txt"
GRC = "countries/Greece.txt"
HAM = "countries/Hamas.txt"
HEZ = "countries/Hezbollah.txt"
IRA = "countries/Iraq.txt"
IRI = "countries/Islamic_republic_Iraq.txt"
IRN = "countries/Iran.txt"
ISI = "countries/Islamic State.txt"
ISL = "countries/Israel.txt"
JIS = "countries/Jaysh al-Islam.txt"
JRD = "countries/Jordan.txt"
KRG = "countries/Iraqi Kurdistan.txt"
KUW = "countries/Kuwait.txt"
LAT = "countries/Liwa_al-Tawhid.txt"
LBN = "countries/Lebanon.txt"
PKK = "countries/Kurdistan Workers Party.txt"
PLE = "countries/Palestine.txt"
RMN = "countries/Faylaq al-Rahman.txt"
ROJ = "countries/Rojava.txt"
RUS = "countries/Russia.txt"
SAS = "countries/Suqour_al-Sham.txt"
SMB = "countries/Syrian Martyrs Brigades.txt"
SRI = "countries/Syria.txt"
STF = "countries/Southern Front.txt"
TNC = "countries/Northern Cyprus.txt"
TRK = "countries/Turkey.txt"
UNI = "countries/USA.txt"